16 17
0 0
0 0	0 0	0 0	0 0	0 0	0 0	0 0	0 0
0 6	4 5	4 7	7 7 2 2 2 2 14 13 11 0
0 1	1 1	1 1	1 1	1 1	1 2	1 1	14 0
0 1	1 1	1 1	1 1	1 1	1 17 1 1 14 0
0 1 1 16 15	15 15 16 2 1 1 2 1 1 2 0
0 1	1 1	1 1	1 1	2 1	1 1	1 1	3 0
0 1 1 1 1 1 1 1 2 1 1 1 1 1 3 0
0 1	1 1	1 2	2 2	2 17 2 2 14	1 3	0
0 1 1 1 1 1 1 6 7 14 13 13 2 2 2 0
0 1 1 1 1 1 1 6 7 14 13 13 13 13 10 0
0 1 1 1 1 1 1 1 1 14 13 13 13 13 11 0
0 1 1 1 1 1 1 13 13 13 13 13 13 13 11 0
0 1 1 1 1 1 1 13 13 13 13 13 13 13 10 0
0 1 1 1 1 1 1 13 13 13 13 13 13 13 12 0
0 1 1 1 1 1 1 13 13 13 13 13 13 13 12 0
0 2 2 2 2 2 5 6 7 14 11 10 10 10 11 0
0 0	0 0	0 0	0 0	0 0	0 0	0 0	0 0